X X X 0 0 0 0 0 0 0 0 0 0 6 0 0 0 0 0 X X
X X 0 0 0 0 0 0 0 0 0 0 0 X 0 0 0 0 0 0 X
X 0 0 1 0 0 0 0 0 0 0 0 X 0 0 0 0 0 5 X X
X X X X 0 2 0 0 0 0 0 X 0 0 0 X X X X X X
X X 0 X X X 0 0 0 0 0 X 0 X X X X X 0 0 X
X X 0 0 0 0 0 0 0 0 X 0 0 0 0 0 0 0 0 X X
X X 0 0 0 0 0 0 0 0 0 0 0 0 0 0 0 0 0 X X
X X X 0 0 0 3 0 X X 0 0 0 X 0 0 0 0 7 X X
X X X X 0 0 X X X 0 0 0 0 0 X X 0 0 X X X
X X X 0 0 0 0 X 0 0 0 0 0 0 0 0 0 0 X X X
X X 0 0 0 0 0 0 0 0 0 0 8 0 0 X X X X X X
X X 0 4 0 0 0 0 0 0 X X X X X X X X X X X
X X X X 0 0 0 0 0 0 X X X X X X X X X X X
X X X X 0 0 0 0 0 X X X X X X X X X X X X
X X X X X 0 0 0 X X X X X X X X X X X X X
X X X X X X X X X X X X X X X X X X X X X