Y Y Y o o o o o o o o o o 6 o o o o o Y Y
X X o o o o o o o o o o o Y o o o o o o X
X o P 1 o o o o o o o P Y o o o o o 5 Y X
X Y Y Y o 2 o o o o o Y o P o Y Y Y Y X X
X X o X Y Y o o o o o X o Y Y X X X o o X
X X o o o o o o o o Y o o o o o o o o Y X
X X o o o o o o P o o o o o o o o o o X X
X X Y o o o 3 o Y Y o o o Y o o o o 7 X X
X X X Y o o Y Y X o o o o o Y Y o o Y X X
X X X o o o o X o o o o o o o o P o X X X
X X o o o o o o o o o P 8 o o Y Y Y X X X
X X o 4 o o o o o o Y Y Y Y Y X X X X X X
X X Y Y o o o o o o X X X X X X X X X X X
X X X X o o o o o Y X X X X X X X X X X X
X X X X Y o P o Y X X X X X X X X X X X X
X X X X X Y Y Y X X X X X X X X X X X X X
